 0  0  0  0  0  0  0  0  0  0  0  0  0  1  1  1  1  1  1  1  1  1  1  1  1  0  0  0  0  0  0  0
 0  0  0  0  0  0  0  0  0  0  0  0  0  1  1  1  1  1  1  1  1  1  1  1  1  0  0  0  0  0  0  0
 0  0  0  0  0  0  0  0  0  0  0  0  0  1  1  6  6  6  6  6  6  6  5  1  1  0  0  0  0  0  0  1
 0  0  0  0  0  0  0  0  0  0  0  0  0  1  1  8  1  1  1  1  1  1  5  1  1  0  1  1  1  1  1  1
 0  0  0  0  0  0  0  0  0  0  0  0  0  1  1  8  1  1  0  0  1  1  5  1  1  0  1  1  1  1  1  1
 0  0  0  0  0  0  0  0  0  0  0  0  0  1  1  8  1  1  0  0  1  1  5  1  1  0  1  1  6  6  6  6
 0  0  0  0  0  0  0  0  0  0  0  0  0  1  1  8  1  1  0  0  1  1  5  1  1  0  1  1  8  1  1  1
 0  0  0  0  0  0  0  0  0  0  0  0  0  1  1  8  1  1  0  0  1  1  5  1  1  0  1  1  8  1  1  0
 1  0  0  0  0  0  0  0  0  0  0  0  0  1  1  8  1  1  0  0  1  1  5  1  1  0  1  1  8  1  1  1
 0  0  0  0  0  0  0  0  0  0  0  0  0  1  1  8  1  1  0  0  1  1  5  1  1  0  1  1  8  1  1  0
 1  1  1  1  1  1  1  1  1  0  0  0  0  1  1  8  1  1  0  0  1  1  5  1  1  0  1  1  8  1  1  0
 1  1  1  1  1  1  1  1  1  0  0  0  0  1  1  8  1  1  0  0  1  1  5  1  1  0  1  1  8  1  1  0
 6  6  6  6  6  6  5  1  1  0  0  0  0  1  1  8  1  1  0  0  1  1  5  1  1  0  1  1  8  1  1  0
 1  1  1  1  1  1  5  1  1  0  0  0  0  1  1  8  1  1  0  0  1  1  5  1  1  0  1  1  8  1  1  0
 0  0  0  0  1  1  5  1  1  0  0  0  0  1  1  8  1  1  0  0  1  1  5  1  1  0  1  1  8  1  1  0
 1  0  0  0  1  1  5  1  1  0  0  0  0  1  1  8  1  1  0  0  1  1  5  1  1  0  1  1  8  1  1  0
 0  0  0  0  1  1  5  1  1  0  0  0  0  1  1  8  1  1  0  0  1  1  5  1  1  0  1  1  8  1  1  0
 0  0  0  0  1  1  5  1  1  0  0  0  0  1  1  8  1  1  0  0  1  1  5  1  1  0  1  1  8  1  1  0
 0  0  0  0  1  1  5  1  1  1  1  1  1  1  1  8  1  1  0  0  1  1  5  1  1  1  1  1  8  1  1  0
 0  0  0  0  1  1  5  1  1  1  1  1  1  1  1  8  1  1  0  0  1  1  5  1  1  1  1  1  8  1  1  0
 0  0  0  0  1  1  6  6  6  6  6  6  6  6  6  8  1  1  0  0  1  1  6  6  6  6  6  6  8  1  1  0
 0  0  0  0  1  1  1  1  1  1  1  1  1  1  1  1  1  1  0  0  1  1  1  1  1  1  1  1  1  1  1  0
 0  0  0  0  0  0  0  0  0  0  0  0  0  0  0  0  0  0  0  0  0  0  0  0  0  0  0  0  0  0  0  0
 1  1  1  1  1  1  1  1  1  1  1  1  1  1  1  1  1  1  1  1  1  1  1  1  1  1  1  1  1  1  1  1
 1  1  1  1  1  1  1  1  1  1  1  1  1  1  1  1  1  1  1  1  1  1  1  1  1  1  1  1  1  1  1  1