0000 0000 0000 0000 0000 0000 0000 0000 0000 0000 0000 0000 0000 0001 0001 0001 0001 0001 0001 0001 0001 0001 0001 0001 0001 0000 0000 0000 0000 0000 0000 0000
0000 0000 0000 0000 0000 0000 0000 0000 0000 0000 0000 0000 0000 0001 0001 0001 0001 0001 0001 0001 0001 0001 0001 0001 0001 0000 0000 0000 0000 0000 0000 0000
0000 0000 0000 0000 0000 0000 0000 0000 0000 0000 0000 0000 0000 0001 0001 0001 0001 0001 0001 0001 0001 0001 0001 0001 0001 0000 0000 0000 0000 0000 0000 0001
0000 0000 0000 0000 0000 0000 0000 0000 0000 0000 0000 0000 0000 0001 0001 0001 0001 0001 0001 0001 0001 0001 0001 0001 0001 0000 0001 0001 0001 0001 0001 0001
0000 0000 0000 0000 0000 0000 0000 0000 0000 0000 0000 0000 0000 0001 0001 0001 0001 0001 0000 0000 0001 0001 0001 0001 0001 0000 0001 0001 0001 0001 0001 0001
0000 0000 0000 0000 0000 0000 0000 0000 0000 0000 0000 0000 0000 0001 0001 0001 0001 0001 0000 0000 0001 0001 0001 0001 0001 0000 0001 0001 0001 0001 0001 0001
0000 0000 0000 0000 0000 0000 0000 0000 0000 0000 0000 0000 0000 0001 0001 0001 0001 0001 0000 0000 0001 0001 0001 0001 0001 0000 0001 0001 0001 0001 0001 0001
0000 0000 0000 0000 0000 0000 0000 0000 0000 0000 0000 0000 0000 0001 0001 0001 0001 0001 0000 0000 0001 0001 0001 0001 0001 0000 0001 0001 0001 0001 0001 0000
0001 0000 0000 0000 0000 0000 0000 0000 0000 0000 0000 0000 0000 0001 0001 0001 0001 0001 0000 0000 0001 0001 0001 0001 0001 0000 0001 0001 0001 0001 0001 0001
0000 0000 0000 0000 0000 0000 0000 0000 0000 0000 0000 0000 0000 0001 0001 0001 0001 0001 0000 0000 0001 0001 0001 0001 0001 0000 0001 0001 0001 0001 0001 0000
0001 0001 0001 0001 0001 0001 0001 0001 0001 0000 0000 0000 0000 0001 0001 0001 0001 0001 0000 0000 0001 0001 0001 0001 0001 0000 0001 0001 0001 0001 0001 0000
0001 0001 0001 0001 0001 0001 0001 0001 0001 0000 0000 0000 0000 0001 0001 0001 0001 0001 0000 0000 0001 0001 0001 0001 0001 0000 0001 0001 0001 0001 0001 0000
0001 0001 0001 0001 0001 0001 0001 0001 0001 0000 0000 0000 0000 0001 0001 0001 0001 0001 0000 0000 0001 0001 0001 0001 0001 0000 0001 0001 0001 0001 0001 0000
0001 0001 0001 0001 0001 0001 0001 0001 0001 0000 0000 0000 0000 0001 0001 0001 0001 0001 0000 0000 0001 0001 0001 0001 0001 0000 0001 0001 0001 0001 0001 0000
0000 0000 0000 0000 0001 0001 0001 0001 0001 0000 0000 0000 0000 0001 0001 0001 0001 0001 0000 0000 0001 0001 0001 0001 0001 0000 0001 0001 0001 0001 0001 0000
0001 0000 0000 0000 0001 0001 0001 0001 0001 0000 0000 0000 0000 0001 0001 0001 0001 0001 0000 0000 0001 0001 0001 0001 0001 0000 0001 0001 0001 0001 0001 0000
0000 0000 0000 0000 0001 0001 0001 0001 0001 0000 0000 0000 0000 0001 0001 0001 0001 0001 0000 0000 0001 0001 0001 0001 0001 0000 0001 0001 0001 0001 0001 0000
0000 0000 0000 0000 0001 0001 0001 0001 0001 0000 0000 0000 0000 0001 0001 0001 0001 0001 0000 0000 0001 0001 0001 0001 0001 0000 0001 0001 0001 0001 0001 0000
0000 0000 0000 0000 0001 0001 0001 0001 0001 0001 0001 0001 0001 0001 0001 0001 0001 0001 0000 0000 0001 0001 0001 0001 0001 0001 0001 0001 0001 0001 0001 0000
0000 0000 0000 0000 0001 0001 0001 0001 0001 0001 0001 0001 0001 0001 0001 0001 0001 0001 0000 0000 0001 0001 0001 0001 0001 0001 0001 0001 0001 0001 0001 0000
0000 0000 0000 0000 0001 0001 0001 0001 0001 0001 0001 0001 0001 0001 0001 0001 0001 0001 0000 0000 0001 0001 0001 0001 0001 0001 0001 0001 0001 0001 0001 0000
0000 0000 0000 0000 0001 0001 0001 0001 0001 0001 0001 0001 0001 0001 0001 0001 0001 0001 0000 0000 0001 0001 0001 0001 0001 0001 0001 0001 0001 0001 0001 0000
0000 0000 0000 0000 0000 0000 0000 0000 0000 0000 0000 0000 0000 0000 0000 0000 0000 0000 0000 0000 0000 0000 0000 0000 0000 0000 0000 0000 0000 0000 0000 0000
0001 0001 0001 0001 0001 0001 0001 0001 0001 0001 0001 0001 0001 0001 0001 0001 0001 0001 0001 0001 0001 0001 0001 0001 0001 0001 0001 0001 0001 0001 0001 0001
0001 0001 0001 0001 0001 0001 0001 0001 0001 0001 0001 0001 0001 0001 0001 0001 0001 0001 0001 0001 0001 0001 0001 0001 0001 0001 0001 0001 0001 0001 0001 0001